NO                   ./image/green_wall.xpm

      SO        ./image/green_wall.xpm

   WE ./image/stone_wall.xpm

EA  ./image/stone_wall.xpm  

C 0, 204, 255
F 101, 67, 33

1111111111111111111111111
1000000000110000000000001
1011000001110000000000001
1001000000000000000000001
111111111011000001110000000000001
100000000011000001110111111111111
11110111111111011100010010001
11110111111111011111110010001
11000000110101011100000010001
10000000000000001100000010001
10000000000000001111010010001
11000001110101011111011000N0111
11110111 1110101 101111010001
11111111 1111111 111111111111