

NO                   ./test.xpm

      SO        ./test.xpm

   WE ./test.xpm 
EA ./test.xpm   

F 220,100,0
C 225,30,0

11111111111111111111111111111111
            11111111000000000110000000000001
      1010000011100000000000011111111
         1001000000000000000000001
111111111011000001110000000000001
0
100000000011000001110111111111111
1110111111   111011100000010001
11110111111111011101010010001
1100000011010101110000001000000
10000000000000001100000010001
10000000000000001101010010001
11000001110101011111011110N0111
11110111 1110101 101111010001
11111111 1111111 111111111111
