

NO                   ./image/green_wall.xpm

      SO        ./image/green_wall.xpm

   WE ./image/stone_wall.xpm
C 0, 204, 255
EA  ./image/stone_wall.xpm  

F 101, 67, 33

       11111111111111111111111111
           100A00110000000000001
           1011000011100000000000001       
           1001000000000000000000001    
111111111011000001110000000000001
10000000001100001110111111111111
11110111111111011100000010001
11110111111111011101010010001
11000000110101011100000010001
10000000000000001100000010001
1000000000000000110101010001
11000001110101011111011110S0111
11110111 1110101 10111101000101
11111111 1111111 111111111111