

NO                   ./image/green_wall.xpm

      SO        ./image/green_wall.xpm

   WE ./image/stone_wall.xpm
C 0, 204, 255
EA  ./image/stone_wall.xpm  

F 101, 67

11111111111111111111111111
1000000000110000W000000001
101100001110000000000001
1001000000000000000000001
111111111011000001110000000000001
100000000011000001110111111111111
11110111111111011100000010001
11110111111111011101010010001
11000000110101011100000010001
100000000S00000001100000010001
10000000000000001101010010001
110000011101010111110111100111
11110111 1110101 101111010001
11111111 11111111 111111111111